"Game_id","Home_ID","Away_ID","Home_pts","Away_pts","Spread","Home_oreb","Away_oreb","Matchup_ID"
22200002,1610612744,1610612747,123,109,14,11,9,4447
22200001,1610612738,1610612755,126,117,9,6,4,3855
22200006,1610612751,1610612740,108,130,-22,9,21,4051
22200007,1610612748,1610612741,108,116,-8,8,12,4148
22200009,1610612763,1610612752,115,112,3,20,18,5263
22200005,1610612737,1610612745,117,107,10,4,15,3745
22200011,1610612759,1610612766,102,129,-27,14,14,5966
22200008,1610612761,1610612739,108,105,3,12,6,3961
22200010,1610612750,1610612760,115,108,7,14,16,5060
22200012,1610612762,1610612743,123,102,21,11,10,4362
22200013,1610612756,1610612742,107,105,2,8,5,4256
22200014,1610612758,1610612757,108,115,-7,4,11,5758
22200004,1610612754,1610612764,107,114,-7,12,14,5464
22200003,1610612765,1610612753,113,109,4,12,10,5365
22200016,1610612747,1610612746,97,103,-6,8,10,4647
22200015,1610612755,1610612749,88,90,-2,6,7,4955
22200019,1610612764,1610612741,102,100,2,5,10,4164
22200020,1610612737,1610612753,108,98,10,9,10,3753
22200022,1610612748,1610612738,104,111,-7,11,12,3848
22200023,1610612752,1610612765,130,106,24,11,13,5265
22200017,1610612766,1610612740,112,124,-12,11,15,4066
22200018,1610612754,1610612759,134,137,-3,14,7,5459
22200025,1610612750,1610612762,126,132,-6,21,19,5062
22200026,1610612744,1610612743,123,128,-5,7,12,4344
22200021,1610612751,1610612761,109,105,4,13,8,5161
22200024,1610612745,1610612763,122,129,-7,13,17,4563
22200027,1610612757,1610612756,113,111,2,13,9,5657
22200034,1610612742,1610612763,137,96,41,15,6,4263
22200031,1610612748,1610612761,112,109,3,6,8,4861
22200035,1610612743,1610612760,122,117,5,9,10,4360
22200030,1610612753,1610612738,120,126,-6,12,7,3853
22200036,1610612758,1610612746,109,111,-2,9,5,4658
22200029,1610612754,1610612765,124,115,9,20,17,5465
22200032,1610612741,1610612739,96,128,-32,10,8,3941
22200033,1610612749,1610612745,125,105,20,8,15,4549
22200028,1610612755,1610612759,105,114,-9,12,12,5559
22200039,1610612739,1610612764,117,107,10,16,4,3964
22200037,1610612747,1610612757,104,106,-2,10,13,4757
22200042,1610612744,1610612758,130,125,5,6,13,4458
22200038,1610612737,1610612766,109,126,-17,16,14,3766
22200043,1610612746,1610612756,95,112,-17,9,13,4656
22200040,1610612740,1610612762,121,122,-1,14,15,4062
22200041,1610612760,1610612750,106,116,-10,11,12,5060
22200048,1610612745,1610612762,114,108,6,17,18,4562
22200045,1610612748,1610612761,90,98,-8,8,10,4861
22200051,1610612757,1610612743,135,110,25,9,10,4357
22200050,1610612750,1610612759,106,115,-9,10,14,5059
22200049,1610612763,1610612751,134,124,10,12,9,5163
22200047,1610612741,1610612738,120,102,18,14,14,3841
22200046,1610612752,1610612753,115,102,13,18,13,5253
22200044,1610612755,1610612754,120,106,14,7,14,5455
22200054,1610612760,1610612746,108,94,14,21,7,4660
22200052,1610612764,1610612765,120,99,21,9,11,6465
22200053,1610612740,1610612742,113,111,2,4,11,4042
22200055,1610612756,1610612744,134,105,29,14,10,4456
22200058,1610612752,1610612766,134,131,3,12,9,5266
22200056,1610612739,1610612753,103,92,11,12,10,3953
22200065,1610612757,1610612748,98,119,-21,11,15,4857
22200064,1610612743,1610612747,110,99,11,9,7,4347
22200062,1610612750,1610612759,134,122,12,0,14,5059
22200059,1610612761,1610612755,119,109,10,6,4,5561
22200063,1610612762,1610612745,109,101,8,11,14,4562
22200060,1610612749,1610612751,110,99,11,14,7,4951
22200061,1610612741,1610612754,124,109,15,9,6,4154
22200057,1610612765,1610612737,113,118,-5,10,10,3765
22200069,1610612758,1610612763,110,125,-15,9,11,5863
22200068,1610612744,1610612748,123,110,13,16,8,4448
22200067,1610612760,1610612746,118,110,8,13,10,4660
22200066,1610612751,1610612742,125,129,-4,13,7,4251
22200070,1610612765,1610612737,112,136,-24,14,10,3765
22200073,1610612761,1610612755,90,112,-22,15,7,5561
22200074,1610612764,1610612754,117,127,-10,9,5,5464
22200072,1610612738,1610612739,123,132,-9,5,9,3839
22200078,1610612743,1610612762,117,101,16,17,8,4362
22200075,1610612749,1610612752,119,108,11,19,13,4952
22200077,1610612759,1610612741,129,124,5,8,15,4159
22200080,1610612757,1610612745,125,111,14,11,13,4557
22200079,1610612756,1610612740,124,111,13,14,9,4056
22200076,1610612750,1610612747,111,102,9,14,12,4750
22200071,1610612753,1610612766,113,93,20,5,10,5366
22200081,1610612758,1610612748,119,113,6,6,9,4858
22200085,1610612749,1610612737,123,115,8,14,12,3749
22200084,1610612741,1610612755,109,114,-5,9,8,4155
22200087,1610612762,1610612763,124,123,1,10,10,6263
22200082,1610612766,1610612744,120,113,7,15,10,4466
22200083,1610612751,1610612754,116,125,-9,6,17,5154
22200086,1610612742,1610612760,111,117,-6,12,9,4260
22200088,1610612746,1610612740,91,112,-21,8,12,4046
22200090,1610612739,1610612752,121,108,13,10,12,3952
22200092,1610612759,1610612750,107,98,9,14,16,5059
22200093,1610612742,1610612753,114,105,9,5,11,4253
22200091,1610612765,1610612744,128,114,14,12,13,4465
22200094,1610612756,1610612745,124,109,15,10,17,4556
22200095,1610612747,1610612743,121,110,11,13,13,4347
22200089,1610612738,1610612764,112,94,18,4,15,3864
22200099,1610612761,1610612737,139,109,30,12,7,3761
22200102,1610612746,1610612745,95,93,2,8,7,4546
22200101,1610612762,1610612763,121,105,16,11,18,6263
22200098,1610612751,1610612754,116,109,7,6,10,5154
22200100,1610612749,1610612765,110,108,2,14,13,4965
22200097,1610612764,1610612755,111,118,-7,9,4,5564
22200096,1610612766,1610612758,108,115,-7,6,10,5866
22200105,1610612760,1610612753,116,108,8,8,12,5360
22200106,1610612756,1610612750,116,107,9,7,10,5056
22200103,1610612751,1610612741,99,108,-9,4,11,4151
22200104,1610612748,1610612744,116,109,7,9,10,4448
22200108,1610612755,1610612764,111,121,-10,6,7,5564
22200117,1610612747,1610612740,120,117,3,11,11,4047
22200112,1610612745,1610612746,101,109,-8,16,9,4546
22200116,1610612757,1610612763,106,111,-5,16,10,5763
22200110,1610612752,1610612737,99,112,-13,12,17,3752
22200115,1610612742,1610612762,103,100,3,7,12,4262
22200114,1610612759,1610612761,100,143,-43,13,9,5961
22200111,1610612741,1610612766,106,88,18,11,13,4166
22200107,1610612739,1610612738,114,113,1,9,8,3839
22200113,1610612749,1610612765,116,91,25,15,2,4965
22200109,1610612748,1610612758,110,107,3,9,4,4858
22200118,1610612753,1610612744,130,129,1,11,9,4453
22200119,1610612760,1610612743,110,122,-12,10,8,4360
22200131,1610612747,1610612762,116,130,-14,9,15,4762
22200124,1610612738,1610612741,123,119,4,7,4,3841
22200129,1610612750,1610612749,102,115,-13,10,7,4950
22200125,1610612763,1610612766,130,99,31,18,12,6366
22200130,1610612756,1610612757,106,108,-2,13,11,5657
22200128,1610612740,1610612744,114,105,9,9,3,4044
22200127,1610612742,1610612761,111,110,1,6,18,4261
22200121,1610612754,1610612748,101,99,2,5,8,4854
22200122,1610612755,1610612752,104,106,-2,13,10,5255
22200120,1610612765,1610612739,88,112,-24,9,10,3965
22200123,1610612764,1610612751,86,128,-42,7,7,5164
22200126,1610612759,1610612746,106,113,-7,6,3,4659
22200139,1610612756,1610612757,102,82,20,11,8,5657
22200138,1610612743,1610612759,126,101,25,10,6,4359
22200135,1610612752,1610612738,118,133,-15,12,8,3852
22200133,1610612766,1610612751,94,98,-4,13,9,5166
22200132,1610612753,1610612758,123,126,-3,7,6,5358
22200134,1610612737,1610612740,124,121,3,12,19,3740
22200136,1610612749,1610612760,108,94,14,18,9,4960
22200137,1610612750,1610612745,129,117,12,9,12,4550
22200141,1610612761,1610612741,113,104,9,23,15,4161
22200142,1610612763,1610612764,103,97,6,12,15,6364
22200140,1610612747,1610612739,100,114,-14,10,9,3947
22200143,1610612746,1610612762,102,110,-8,4,7,4662
22200152,1610612763,1610612738,106,109,-3,8,7,3863
22200158,1610612746,1610612739,119,117,2,4,10,3946
22200146,1610612765,1610612760,112,103,9,16,16,6065
22200149,1610612737,1610612749,117,98,19,12,6,3749
22200155,1610612742,1610612751,96,94,2,12,14,4251
22200153,1610612750,1610612752,107,120,-13,4,9,5052
22200151,1610612741,1610612761,111,97,14,9,5,4161
22200157,1610612762,1610612747,139,116,23,10,7,4762
22200145,1610612753,1610612745,127,134,-7,11,14,4553
22200147,1610612754,1610612740,129,122,7,10,13,4054
22200144,1610612766,1610612764,100,108,-8,17,10,6466
22200150,1610612748,1610612757,107,110,-3,5,4,4857
22200148,1610612755,1610612756,100,88,12,15,6,5556
22200156,1610612744,1610612758,116,113,3,8,9,4458
22200154,1610612759,1610612743,109,115,-6,10,8,4359
22200160,1610612754,1610612743,119,122,-3,11,11,4354
22200162,1610612737,1610612762,119,125,-6,17,13,3762
22200170,1610612746,1610612747,114,101,13,6,8,4647
22200161,1610612753,1610612742,94,87,7,4,4,4253
22200164,1610612751,1610612752,112,85,27,11,11,5152
22200165,1610612761,1610612745,116,109,7,22,16,4561
22200159,1610612766,1610612757,95,105,-10,20,8,5766
22200163,1610612738,1610612765,128,112,16,8,15,3865
22200166,1610612741,1610612740,111,115,-4,6,13,4041
22200167,1610612750,1610612756,117,129,-12,8,10,5056
22200169,1610612759,1610612763,122,124,-2,13,18,5963
22200168,1610612760,1610612749,132,136,-4,16,11,4960
22200171,1610612758,1610612739,127,120,7,2,12,3958
22200172,1610612764,1610612742,113,105,8,8,7,4264
22200173,1610612737,1610612755,104,95,9,11,9,3755
22200174,1610612748,1610612766,117,112,5,8,8,4866
22200175,1610612740,1610612757,95,106,-11,9,11,4057
22200178,1610612752,1610612765,121,112,9,16,12,5265
22200183,1610612747,1610612758,114,120,-6,14,10,4758
22200177,1610612753,1610612756,114,97,17,9,11,5356
22200182,1610612744,1610612739,106,101,5,8,14,3944
22200181,1610612763,1610612750,114,103,11,15,7,5063
22200180,1610612759,1610612749,111,93,18,9,21,4959
22200179,1610612760,1610612761,132,113,19,15,14,6061
22200176,1610612738,1610612743,131,112,19,10,11,3843
22200186,1610612765,1610612738,108,117,-9,11,9,3865
22200188,1610612755,1610612737,121,109,12,2,12,3755
22200184,1610612746,1610612751,95,110,-15,10,6,4651
22200185,1610612764,1610612762,121,112,9,6,7,6264
22200191,1610612740,1610612745,119,106,13,12,10,4045
22200187,1610612754,1610612761,118,104,14,11,16,5461
22200189,1610612748,1610612766,132,115,17,9,4,4866
22200190,1610612742,1610612757,117,112,5,7,12,4257
22200198,1610612747,1610612751,116,103,13,12,8,4751
22200194,1610612764,1610612763,102,92,10,9,14,6364
22200193,1610612739,1610612750,124,129,-5,16,11,3950
22200192,1610612752,1610612760,135,145,-10,13,4,5260
22200195,1610612755,1610612762,105,98,7,8,18,5562
22200196,1610612741,1610612743,103,126,-23,8,5,4143
22200197,1610612758,1610612744,122,115,7,9,8,4458
22200199,1610612765,1610612761,111,115,-4,11,12,6165
22200200,1610612753,1610612766,105,112,-7,22,14,5366
22200205,1610612744,1610612759,132,95,37,5,22,4459
22200203,1610612745,1610612746,106,122,-16,10,9,4546
22200202,1610612748,1610612756,113,112,1,17,20,4856
22200201,1610612738,1610612760,126,122,4,10,10,3860
22200204,1610612749,1610612737,106,121,-15,11,13,3749
22200207,1610612742,1610612746,103,101,2,8,3,4246
22200208,1610612762,1610612752,111,118,-7,15,13,5262
22200209,1610612757,1610612759,117,110,7,9,11,5759
22200210,1610612758,1610612751,153,121,32,9,3,5158
22200206,1610612740,1610612763,113,102,11,7,14,4063
22200213,1610612764,1610612760,120,121,-1,11,9,6064
22200216,1610612749,1610612739,113,98,15,13,6,3949
22200217,1610612740,1610612741,124,110,14,12,7,4041
22200218,1610612742,1610612745,92,101,-9,13,9,4245
22200219,1610612743,1610612752,103,106,-3,8,6,4352
22200220,1610612756,1610612744,130,119,11,8,6,4456
22200215,1610612761,1610612748,112,104,8,16,4,4861
22200214,1610612737,1610612738,101,126,-25,14,6,3738
22200212,1610612753,1610612750,108,126,-18,12,8,5053
22200211,1610612766,1610612754,113,125,-12,14,7,5466
22200222,1610612758,1610612759,130,112,18,6,7,5859
22200221,1610612757,1610612751,107,109,-2,8,5,5157
22200223,1610612746,1610612765,96,91,5,10,10,4665
22200229,1610612763,1610612760,121,110,11,17,8,6063
22200228,1610612745,1610612754,91,99,-8,14,12,4554
22200225,1610612739,1610612766,132,122,10,7,17,3966
22200224,1610612764,1610612748,107,106,1,8,10,4864
22200234,1610612747,1610612765,128,121,7,7,10,4765
22200233,1610612744,1610612752,111,101,10,12,13,4452
22200232,1610612762,1610612756,134,133,1,11,12,5662
22200230,1610612742,1610612743,127,99,28,6,13,4243
22200227,1610612741,1610612753,107,108,-1,13,6,4153
22200231,1610612740,1610612738,109,117,-8,7,11,3840
22200226,1610612755,1610612749,110,102,8,6,8,4955
22200235,1610612737,1610612761,124,122,2,11,17,3761
22200237,1610612755,1610612750,109,112,-3,4,8,5055
22200238,1610612757,1610612762,113,118,-5,10,11,5762
22200239,1610612746,1610612759,119,97,22,7,15,4659
22200236,1610612754,1610612753,114,113,1,12,11,5354
22200242,1610612758,1610612765,137,129,8,8,10,5865
22200243,1610612751,1610612763,127,115,12,5,13,5163
22200245,1610612745,1610612744,120,127,-7,12,8,4445
22200241,1610612764,1610612766,106,102,4,14,15,6466
22200246,1610612742,1610612743,97,98,-1,6,4,4243
22200247,1610612747,1610612759,123,92,31,5,13,4759
22200240,1610612756,1610612752,116,95,21,22,10,5256
22200244,1610612739,1610612748,113,87,26,13,11,3948
22200254,1610612760,1610612752,119,129,-10,11,14,5260
22200250,1610612741,1610612738,121,107,14,8,5,3841
22200248,1610612739,1610612737,114,102,12,3,10,3739
22200251,1610612749,1610612757,119,111,8,10,12,4957
22200255,1610612746,1610612762,121,114,7,12,16,4662
22200249,1610612754,1610612753,123,102,21,12,12,5354
22200253,1610612740,1610612744,128,83,45,11,4,4044
22200252,1610612750,1610612748,105,101,4,6,12,4850
22200258,1610612743,1610612765,108,110,-2,15,12,4365
22200259,1610612756,1610612747,115,105,10,8,7,4756
22200257,1610612763,1610612758,109,113,-4,13,9,5863
22200256,1610612755,1610612751,115,106,9,20,4,5155
22200265,1610612748,1610612764,113,105,8,14,7,4864
22200267,1610612749,1610612741,113,118,-5,11,5,4149
22200263,1610612737,1610612758,115,106,9,10,10,3758
22200261,1610612739,1610612757,114,96,18,11,11,3957
22200270,1610612762,1610612765,116,125,-9,7,8,6265
22200262,1610612754,1610612750,101,115,-14,13,8,5054
22200271,1610612744,1610612746,124,107,17,12,10,4446
22200269,1610612759,1610612740,110,129,-19,8,8,4059
22200260,1610612766,1610612755,107,101,6,11,8,5566
22200268,1610612760,1610612743,126,131,-5,12,17,4360
22200264,1610612738,1610612742,125,112,13,6,5,3842
22200266,1610612761,1610612751,98,112,-14,23,7,5161
22200284,1610612744,1610612762,129,118,11,16,15,4462
22200277,1610612748,1610612764,110,107,3,10,13,4864
22200274,1610612752,1610612757,129,132,-3,12,13,5257
22200272,1610612766,1610612750,110,108,2,15,11,5066
22200285,1610612746,1610612743,104,114,-10,4,10,4346
22200273,1610612753,1610612755,99,107,-8,9,13,5355
22200275,1610612738,1610612758,122,104,18,4,11,3858
22200283,1610612756,1610612765,108,102,6,11,19,5665
22200281,1610612760,1610612741,123,119,4,10,14,4160
22200278,1610612745,1610612737,128,122,6,22,6,3745
22200276,1610612754,1610612751,128,117,11,5,5,5154
22200282,1610612759,1610612747,94,105,-11,20,10,4759
22200279,1610612763,1610612740,132,111,21,13,11,4063
22200280,1610612749,1610612739,117,102,15,8,10,3949
22200286,1610612761,1610612742,105,100,5,17,4,4261
22200289,1610612756,1610612762,113,112,1,18,8,5662
22200288,1610612759,1610612747,138,143,-5,17,3,4759
22200287,1610612745,1610612760,118,105,13,11,16,4560
22200293,1610612737,1610612748,98,106,-8,8,6,3748
22200292,1610612746,1610612754,114,100,14,18,9,4654
22200295,1610612765,1610612739,94,102,-8,7,10,3965
22200291,1610612750,1610612744,114,137,-23,6,8,4450
22200297,1610612753,1610612755,103,133,-30,7,6,5355
22200298,1610612749,1610612742,124,115,9,8,6,4249
22200290,1610612751,1610612757,111,97,14,4,11,5157
22200296,1610612752,1610612763,123,127,-4,12,16,5263
22200294,1610612738,1610612764,130,121,9,10,6,3864
22200308,1610612747,1610612754,115,116,-1,18,12,4754
22200306,1610612762,1610612741,107,114,-7,9,13,4162
22200301,1610612738,1610612766,140,105,35,9,13,3866
22200302,1610612751,1610612753,109,102,7,8,9,5153
22200304,1610612740,1610612760,105,101,4,14,18,4060
22200307,1610612758,1610612756,117,122,-5,8,11,5658
22200303,1610612761,1610612739,100,88,12,7,13,3961
22200300,1610612764,1610612750,142,127,15,7,15,5064
22200305,1610612743,1610612745,129,113,16,13,12,4345
22200299,1610612755,1610612737,104,101,3,10,8,3755
22200309,1610612765,1610612752,110,140,-30,7,17,5265
22200310,1610612742,1610612744,116,113,3,8,10,4244
22200311,1610612757,1610612746,112,118,-6,9,14,4657
22200320,1610612743,1610612745,120,100,20,8,10,4345
22200324,1610612747,1610612757,128,109,19,13,12,4757
22200321,1610612756,1610612741,132,113,19,10,5,4156
22200315,1610612751,1610612764,113,107,6,4,14,5164
22200318,1610612740,1610612761,126,108,18,12,3,4061
22200314,1610612738,1610612748,134,121,13,11,9,3848
22200323,1610612758,1610612754,137,114,23,11,12,5458
22200322,1610612762,1610612746,125,112,13,13,17,4662
22200319,1610612760,1610612759,119,111,8,15,13,5960
22200312,1610612739,1610612755,113,85,28,6,7,3955
22200317,1610612750,1610612763,109,101,8,5,20,5063
22200316,1610612752,1610612749,103,109,-6,19,14,4952
22200313,1610612753,1610612737,108,125,-17,6,14,3753
22200325,1610612765,1610612742,131,125,6,13,4,4265
22200327,1610612737,1610612743,117,109,8,12,9,3743
22200333,1610612759,1610612740,99,117,-18,10,10,4059
22200332,1610612763,1610612755,117,109,8,19,10,5563
22200334,1610612756,1610612745,121,122,-1,9,13,4556
22200329,1610612751,1610612761,114,105,9,7,11,5161
22200335,1610612762,1610612754,139,119,20,8,9,5462
22200328,1610612738,1610612748,116,120,-4,7,12,3848
22200336,1610612744,1610612741,119,111,8,7,6,4144
22200331,1610612749,1610612747,129,133,-4,10,12,4749
22200330,1610612739,1610612753,107,96,11,5,11,3953
22200326,1610612766,1610612764,117,116,1,19,18,6466
22200337,1610612752,1610612742,100,121,-21,7,14,4252
22200338,1610612746,1610612758,96,123,-27,17,8,4658
22200339,1610612766,1610612749,96,105,-9,9,8,4966
22200343,1610612762,1610612757,111,116,-5,10,12,5762
22200341,1610612750,1610612760,128,135,-7,12,13,5060
22200342,1610612744,1610612745,120,101,19,6,14,4445
22200340,1610612761,1610612753,121,108,13,12,5,5361
22200345,1610612759,1610612756,95,133,-38,12,14,5659
22200350,1610612758,1610612741,110,101,9,5,7,4158
22200347,1610612765,1610612763,112,122,-10,8,12,6365
22200344,1610612740,1610612743,121,106,15,6,9,4043
22200346,1610612751,1610612738,92,103,-11,11,8,3851
22200351,1610612757,1610612754,116,100,16,11,12,5457
22200349,1610612764,1610612747,119,130,-11,11,9,4764
22200348,1610612752,1610612739,92,81,11,14,8,3952
22200353,1610612753,1610612749,102,109,-7,15,7,4953
22200356,1610612745,1610612755,132,123,9,16,11,4555
22200359,1610612744,1610612754,104,112,-8,12,7,4454
22200358,1610612742,1610612756,130,111,19,10,13,4256
22200352,1610612766,1610612746,117,119,-2,14,13,4666
22200355,1610612761,1610612738,110,116,-6,12,13,3861
22200357,1610612763,1610612748,101,93,8,4,9,4863
22200354,1610612737,1610612760,114,121,-7,17,14,3760
22200362,1610612743,1610612742,115,116,-1,8,4,4243
22200360,1610612739,1610612747,116,102,14,9,14,3947
22200361,1610612748,1610612765,96,116,-20,7,9,4865
22200373,1610612756,1610612738,98,125,-27,13,11,3856
22200368,1610612763,1610612760,123,102,21,10,14,6063
22200371,1610612740,1610612765,104,98,6,10,8,4065
22200363,1610612753,1610612746,116,111,5,16,17,4653
22200365,1610612752,1610612737,113,89,24,13,11,3752
22200367,1610612741,1610612764,115,111,4,6,6,4164
22200372,1610612762,1610612744,124,123,1,9,14,4462
22200364,1610612751,1610612766,122,116,6,5,10,5166
22200366,1610612761,1610612747,126,113,13,17,10,4761
22200370,1610612750,1610612754,121,115,6,16,4,5054
22200369,1610612749,1610612758,126,113,13,17,8,4958
22200374,1610612748,1610612746,115,110,5,7,7,4648
22200376,1610612757,1610612743,120,121,-1,13,16,4357
22200375,1610612759,1610612745,118,109,9,7,16,4559
22200385,1610612762,1610612750,108,118,-10,12,6,5062
22200378,1610612754,1610612764,121,111,10,13,12,5464
22200381,1610612739,1610612758,95,106,-11,8,5,3958
22200386,1610612742,1610612749,105,106,-1,12,13,4249
22200379,1610612753,1610612761,113,109,4,3,7,5361
22200377,1610612766,1610612752,102,121,-19,12,16,5266
22200382,1610612755,1610612747,133,122,11,7,7,4755
22200383,1610612763,1610612765,114,103,11,12,13,6365
22200380,1610612751,1610612737,120,116,4,9,12,3751
22200384,1610612740,1610612756,128,117,11,13,8,4056
22200388,1610612754,1610612751,133,136,-3,7,29,5154
22200394,1610612757,1610612750,124,118,6,11,4,5057
22200387,1610612748,1610612759,111,115,-4,5,9,4859
22200389,1610612764,1610612746,107,114,-7,8,9,4664
22200391,1610612741,1610612742,144,115,29,4,8,4142
22200393,1610612743,1610612762,115,110,5,6,10,4362
22200392,1610612744,1610612738,123,107,16,11,6,3844
22200390,1610612739,1610612760,110,102,8,12,7,3960
22200399,1610612755,1610612766,131,113,18,9,15,5566
22200397,1610612752,1610612758,112,99,13,15,11,5258
22200396,1610612765,1610612747,117,124,-7,10,6,4765
22200398,1610612753,1610612761,111,99,12,11,7,5361
22200395,1610612740,1610612756,129,124,5,7,19,4056
22200400,1610612737,1610612741,123,122,1,8,13,3741
22200401,1610612745,1610612749,97,92,5,10,13,4549
22200402,1610612754,1610612748,82,87,-5,8,9,4854
22200404,1610612763,1610612737,128,103,25,5,20,3763
22200406,1610612759,1610612739,112,111,1,19,15,3959
22200405,1610612742,1610612760,121,114,7,16,10,4260
22200407,1610612757,1610612750,133,112,21,11,7,5057
22200408,1610612746,1610612738,113,93,20,11,5,3846
22200403,1610612764,1610612751,100,112,-12,6,7,5164
22200412,1610612762,1610612740,121,100,21,19,15,4062
22200413,1610612747,1610612738,118,122,-4,7,13,3847
22200409,1610612755,1610612758,123,103,20,4,13,5558
22200411,1610612745,1610612756,111,97,14,17,18,4556
22200410,1610612749,1610612744,128,111,17,12,12,4449
22200422,1610612743,1610612764,141,128,13,7,4,4364
22200416,1610612753,1610612737,135,124,11,14,11,3753
22200415,1610612754,1610612744,125,119,6,5,12,4454
22200414,1610612766,1610612765,134,141,-7,17,12,6566
22200417,1610612761,1610612758,123,124,-1,11,13,5861
22200419,1610612760,1610612748,108,110,-2,7,7,4860
22200418,1610612741,1610612752,120,128,-8,3,15,4152
22200421,1610612742,1610612739,90,105,-15,6,5,3942
22200423,1610612746,1610612750,99,88,11,14,7,4650
22200420,1610612759,1610612757,112,128,-16,14,5,5759
22200424,1610612745,1610612748,108,111,-3,18,14,4548
22200425,1610612763,1610612749,142,101,41,14,11,4963
22200427,1610612746,1610612756,95,111,-16,21,15,4656
22200426,1610612762,1610612740,132,129,3,11,19,4062
22200431,1610612739,1610612754,118,112,6,6,5,3954
22200429,1610612765,1610612758,113,122,-9,14,4,5865
22200428,1610612766,1610612737,106,125,-19,15,4,3766
22200435,1610612760,1610612750,110,112,-2,9,11,5060
22200434,1610612741,1610612752,91,114,-23,2,15,4152
22200436,1610612742,1610612757,130,110,20,3,10,4257
22200432,1610612755,1610612744,118,106,12,11,13,4455
22200433,1610612761,1610612751,116,119,-3,7,4,5161
22200430,1610612738,1610612753,109,117,-8,10,15,3853
22200437,1610612747,1610612743,126,108,18,11,9,4347
22200444,1610612756,1610612740,118,114,4,10,4,4056
22200442,1610612749,1610612762,123,97,26,15,7,4962
22200443,1610612760,1610612763,115,109,6,9,10,6063
22200440,1610612739,1610612742,100,99,1,9,5,3942
22200439,1610612759,1610612748,101,111,-10,7,8,4859
22200441,1610612745,1610612757,95,107,-12,18,10,4557
22200438,1610612746,1610612764,102,93,9,12,7,4664
22200445,1610612738,1610612753,92,95,-3,11,6,3853
22200450,1610612743,1610612766,119,115,4,15,12,4366
22200451,1610612747,1610612764,119,117,2,6,10,4764
22200447,1610612765,1610612751,121,124,-3,11,4,5165
22200448,1610612761,1610612744,110,126,-16,18,12,4461
22200446,1610612754,1610612752,106,109,-3,12,14,5254
22200449,1610612750,1610612741,150,126,24,4,6,4150
22200457,1610612740,1610612749,119,128,-9,17,8,4049
22200453,1610612755,1610612761,104,101,3,4,9,5561
22200454,1610612737,1610612753,126,125,1,6,10,3753
22200455,1610612745,1610612759,105,124,-19,16,9,4559
22200456,1610612750,1610612742,116,106,10,9,8,4250
22200458,1610612760,1610612757,123,121,2,11,14,5760
22200459,1610612756,1610612747,130,104,26,15,10,4756
22200460,1610612758,1610612766,119,125,-6,10,11,5866
22200452,1610612739,1610612762,122,99,23,4,15,3962
22200463,1610612752,1610612744,132,94,38,14,4,4452
22200462,1610612748,1610612741,103,113,-10,9,5,4148
22200464,1610612756,1610612764,110,113,-3,15,9,5664
22200465,1610612743,1610612763,105,91,14,13,7,4363
22200461,1610612765,1610612762,111,126,-15,9,12,6265
22200468,1610612737,1610612741,108,110,-2,9,8,3741
22200473,1610612750,1610612742,99,104,-5,8,7,4250
22200467,1610612755,1610612765,113,93,20,13,11,5565
22200466,1610612739,1610612749,114,106,8,9,13,3949
22200470,1610612751,1610612744,143,113,30,3,9,4451
22200472,1610612745,1610612753,110,116,-6,9,11,4553
22200469,1610612738,1610612754,112,117,-5,25,12,3854
22200474,1610612760,1610612757,101,98,3,9,9,5760
22200471,1610612752,1610612761,106,113,-7,9,16,5261
22200475,1610612758,1610612747,134,120,14,10,5,4758
22200476,1610612746,1610612766,126,105,21,5,11,4666
22200478,1610612762,1610612764,120,112,8,8,3,6264
22200477,1610612740,1610612759,126,117,9,16,14,4059
22200480,1610612755,1610612746,119,114,5,6,6,4655
22200479,1610612753,1610612759,133,113,20,7,13,5359
22200482,1610612738,1610612750,121,109,12,20,11,3850
22200481,1610612737,1610612765,130,105,25,8,9,3765
22200483,1610612751,1610612749,118,100,18,12,13,4951
22200485,1610612752,1610612741,117,118,-1,12,11,4152
22200486,1610612748,1610612754,108,111,-3,13,9,4854
22200487,1610612745,1610612742,106,112,-6,12,7,4245
22200484,1610612739,1610612761,107,118,-11,6,11,3961
22200492,1610612747,1610612766,130,134,-4,12,11,4766
22200490,1610612756,1610612763,100,125,-25,11,19,5663
22200491,1610612758,1610612764,111,125,-14,13,5,5864
22200489,1610612743,1610612757,120,107,13,4,13,4357
22200488,1610612760,1610612740,125,128,-3,10,13,4060
22200495,1610612738,1610612749,139,118,21,5,8,3849
22200493,1610612752,1610612755,112,119,-7,12,5,5255
22200497,1610612743,1610612756,128,125,3,12,12,4356
22200494,1610612742,1610612747,124,115,9,11,6,4247
22200496,1610612744,1610612763,123,109,14,9,9,4463
22200501,1610612741,1610612745,118,133,-15,8,8,4145
22200500,1610612748,1610612750,113,110,3,13,8,4850
22200502,1610612740,1610612754,113,93,20,16,6,4054
22200499,1610612765,1610612746,131,142,-11,16,10,4665
22200504,1610612757,1610612766,124,113,11,10,18,5766
22200498,1610612739,1610612751,117,125,-8,10,7,3951
22200503,1610612759,1610612762,126,122,4,6,16,5962
22200509,1610612761,1610612746,113,124,-11,10,15,4661
22200508,1610612754,1610612737,129,114,15,7,9,3754
22200513,1610612744,1610612766,110,105,5,9,9,4466
22200514,1610612758,1610612743,106,113,-7,8,10,4358
22200511,1610612760,1610612759,130,114,16,13,16,5960
22200510,1610612763,1610612756,108,125,-17,15,15,5663
22200505,1610612753,1610612747,110,129,-19,8,9,4753
22200507,1610612738,1610612745,126,102,24,9,13,3845
22200506,1610612764,1610612755,116,111,5,14,10,5564
22200512,1610612742,1610612752,126,121,5,7,17,4252
22200516,1610612764,1610612756,127,102,25,12,11,5664
22200518,1610612748,1610612747,112,98,14,10,8,4748
22200517,1610612737,1610612751,107,108,-1,11,5,3751
22200521,1610612744,1610612762,112,107,5,10,10,4462
22200522,1610612758,1610612743,127,126,1,11,7,4358
22200515,1610612765,1610612753,121,101,20,11,15,5365
22200520,1610612740,1610612750,119,118,1,9,5,4050
22200519,1610612741,1610612749,119,113,6,7,22,4149
22200523,1610612766,1610612760,121,113,8,12,11,6066
22200526,1610612761,1610612763,106,119,-13,17,17,6163
22200528,1610612742,1610612745,129,114,15,6,12,4245
22200527,1610612759,1610612752,122,115,7,14,13,5259
22200525,1610612738,1610612746,116,110,6,11,8,3846
22200524,1610612754,1610612739,135,126,9,4,17,3954
22200529,1610612753,1610612764,100,119,-19,8,4,5364
22200530,1610612737,1610612747,121,130,-9,12,12,3747
22200531,1610612761,1610612756,113,104,9,8,9,5661
22200532,1610612741,1610612765,132,118,14,12,13,4165
22200536,1610612744,1610612757,118,112,6,17,17,4457
22200534,1610612740,1610612755,127,116,11,7,3,4055
22200537,1610612758,1610612762,126,125,1,10,7,5862
22200535,1610612743,1610612748,124,119,5,5,11,4348
22200533,1610612749,1610612750,123,114,9,20,7,4950
22200538,1610612754,1610612746,131,130,1,8,8,4654
22200540,1610612741,1610612739,102,103,-1,9,15,3941
22200542,1610612759,1610612742,125,126,-1,15,6,4259
22200541,1610612745,1610612752,88,108,-20,12,16,4552
22200544,1610612750,1610612765,104,116,-12,9,15,5065
22200543,1610612763,1610612740,116,101,15,13,15,4063
22200539,1610612766,1610612751,106,123,-17,14,2,5166
22200546,1610612762,1610612748,123,126,-3,16,10,4862
22200545,1610612760,1610612755,96,115,-19,15,14,5560
22200547,1610612763,1610612758,118,108,10,21,14,5863
22200549,1610612743,1610612738,123,111,12,1,10,3843
22200548,1610612749,1610612764,95,118,-23,14,12,4964
22200551,1610612766,1610612747,115,121,-6,8,9,4766
22200550,1610612752,1610612756,102,83,19,5,5,5256
22200554,1610612755,1610612740,120,111,9,7,10,4055
22200553,1610612754,1610612761,122,114,8,15,12,5461
22200552,1610612739,1610612741,145,134,11,13,6,3941
22200557,1610612750,1610612743,124,111,13,11,18,4350
22200555,1610612751,1610612759,139,103,36,7,15,5159
22200556,1610612745,1610612742,106,111,-5,8,8,4245
22200558,1610612744,1610612737,143,141,2,23,10,3744
22200560,1610612746,1610612748,100,110,-10,3,12,4648
22200559,1610612757,1610612765,135,106,29,6,9,5765
22200561,1610612749,1610612764,123,113,10,15,14,4964
22200562,1610612760,1610612738,150,117,33,9,11,3860
22200563,1610612762,1610612758,115,117,-2,12,7,5862
22200565,1610612739,1610612756,90,88,2,7,8,3956
22200564,1610612766,1610612763,107,131,-24,10,11,6366
22200566,1610612753,1610612760,126,115,11,13,9,5360
22200567,1610612755,1610612754,129,126,3,14,13,5455
22200568,1610612752,1610612759,117,114,3,14,9,5259
22200572,1610612740,1610612745,119,108,11,15,12,4045
22200569,1610612761,1610612749,101,104,-3,14,13,4961
22200570,1610612741,1610612751,121,112,9,6,5,4151
22200571,1610612750,1610612757,113,106,7,8,12,5057
22200573,1610612744,1610612765,119,122,-3,9,11,4465
22200575,1610612758,1610612737,117,120,-3,10,7,3758
22200574,1610612747,1610612748,112,109,3,9,14,4748
22200578,1610612745,1610612762,114,131,-17,14,9,4562
22200577,1610612742,1610612738,95,124,-29,11,10,3842
22200579,1610612743,1610612746,122,91,31,10,8,4346
22200576,1610612753,1610612763,115,123,-8,7,9,5363
22200583,1610612749,1610612766,109,138,-29,12,13,4966
22200585,1610612759,1610612765,121,109,12,7,15,5965
22200584,1610612760,1610612764,127,110,17,11,11,6064
22200586,1610612740,1610612751,102,108,-6,14,10,4051
22200582,1610612761,1610612752,108,112,-4,12,13,5261
22200580,1610612754,1610612757,108,99,9,4,12,5457
22200581,1610612755,1610612741,112,126,-14,12,8,4155
22200588,1610612743,1610612739,121,108,13,13,18,3943
22200590,1610612747,1610612737,130,114,16,7,7,3747
22200589,1610612756,1610612748,96,104,-8,8,5,4856
22200587,1610612750,1610612746,128,115,13,10,18,4650
22200591,1610612759,1610612738,116,121,-5,12,8,3859
22200592,1610612741,1610612762,126,118,8,7,7,4162
22200595,1610612758,1610612747,134,136,-2,13,10,4758
22200593,1610612742,1610612740,127,117,10,5,15,4042
22200594,1610612744,1610612753,101,115,-14,11,7,4453
22200600,1610612763,1610612762,123,118,5,13,8,6263
22200596,1610612765,1610612755,111,123,-12,10,14,5565
22200597,1610612761,1610612757,117,105,12,13,10,5761
22200604,1610612746,1610612737,108,112,-4,21,7,3746
22200598,1610612754,1610612766,116,111,5,8,13,5466
22200599,1610612748,1610612751,101,102,-1,16,6,4851
22200601,1610612745,1610612750,96,104,-8,12,9,4550
22200602,1610612760,1610612742,120,109,11,12,8,4260
22200603,1610612756,1610612739,98,112,-14,6,3,3956
22200605,1610612764,1610612740,112,132,-20,7,12,4064
22200610,1610612758,1610612753,136,111,25,11,9,5358
22200607,1610612752,1610612749,107,111,-4,18,12,4952
22200606,1610612738,1610612741,107,99,8,9,6,3841
22200609,1610612743,1610612747,122,109,13,14,11,4347
22200608,1610612763,1610612759,121,113,8,11,12,5963
22200613,1610612761,1610612766,132,120,12,18,6,6166
22200612,1610612755,1610612765,147,116,31,10,3,5565
22200617,1610612746,1610612742,113,101,12,12,3,4246
22200615,1610612744,1610612756,113,125,-12,16,19,4456
22200611,1610612748,1610612760,112,111,1,13,14,4860
22200616,1610612757,1610612753,106,109,-3,13,6,5357
22200614,1610612762,1610612739,116,114,2,15,7,3962
22200619,1610612764,1610612741,100,97,3,12,8,4164
22200625,1610612758,1610612745,135,115,20,9,8,4558
22200624,1610612743,1610612756,126,97,29,7,15,4356
22200623,1610612763,1610612759,135,129,6,17,17,5963
22200620,1610612737,1610612749,105,114,-9,6,14,3749
22200622,1610612752,1610612754,119,113,6,12,8,5254
22200621,1610612738,1610612740,125,114,11,11,4,3840
22200618,1610612765,1610612750,135,118,17,7,13,5065
22200629,1610612761,1610612766,124,114,10,8,9,6166
22200628,1610612748,1610612749,108,102,6,18,8,4849
22200626,1610612755,1610612760,114,133,-19,9,5,5560
22200630,1610612747,1610612742,115,119,-4,14,3,4247
22200627,1610612751,1610612738,98,109,-11,4,12,3851
22200631,1610612757,1610612739,113,119,-6,5,12,3957
22200632,1610612765,1610612740,110,116,-6,7,8,4065
22200634,1610612764,1610612752,108,112,-4,12,14,5264
22200633,1610612754,1610612737,111,113,-2,19,14,3754
22200635,1610612759,1610612744,113,144,-31,7,12,4459
22200637,1610612750,1610612756,121,116,5,4,9,5056
22200636,1610612741,1610612760,110,124,-14,10,12,4160
22200638,1610612762,1610612753,112,108,4,17,11,5362
22200639,1610612746,1610612743,103,115,-12,11,10,4346
22200640,1610612758,1610612745,139,114,25,14,12,4558
22200642,1610612766,1610612738,106,122,-16,10,14,3866
22200641,1610612748,1610612749,111,95,16,13,7,4849
22200643,1610612754,1610612763,112,130,-18,16,7,5463
22200644,1610612761,1610612737,103,114,-11,11,5,3761
22200645,1610612750,1610612739,110,102,8,4,8,3950
22200647,1610612757,1610612742,136,119,17,10,2,4257
22200646,1610612762,1610612755,117,118,-1,10,9,5562
22200648,1610612765,1610612752,104,117,-13,9,18,5265
22200651,1610612751,1610612760,102,112,-10,14,11,5160
22200652,1610612759,1610612758,119,132,-13,11,7,5859
22200650,1610612741,1610612744,132,118,14,7,7,4144
22200653,1610612743,1610612753,119,116,3,12,10,4353
22200654,1610612757,1610612742,140,123,17,8,13,4257
22200655,1610612747,1610612755,112,113,-1,4,5,4755
22200649,1610612746,1610612745,121,100,21,11,10,4546
22200661,1610612737,1610612748,121,113,8,2,12,3748
22200664,1610612747,1610612745,140,132,8,9,17,4547
22200663,1610612763,1610612756,136,106,30,13,9,5663
22200658,1610612739,1610612740,113,103,10,13,3,3940
22200659,1610612752,1610612761,121,123,-2,20,14,5261
22200660,1610612764,1610612744,118,127,-9,6,9,4464
22200656,1610612766,1610612738,118,130,-12,13,14,3866
22200662,1610612750,1610612762,125,126,-1,16,14,5062
22200657,1610612749,1610612754,132,119,13,9,4,4954
22200666,1610612759,1610612751,106,98,8,13,10,5159
22200665,1610612749,1610612761,130,122,8,6,20,4961
22200667,1610612743,1610612757,122,113,9,11,5,4357
22200668,1610612746,1610612755,110,120,-10,8,8,4655
22200677,1610612747,1610612758,111,116,-5,6,14,4758
22200676,1610612743,1610612750,122,118,4,8,12,4350
22200675,1610612762,1610612746,126,103,23,9,16,4662
22200674,1610612760,1610612754,126,106,20,13,20,5460
22200671,1610612745,1610612766,117,122,-5,12,11,4566
22200673,1610612740,1610612748,98,124,-26,9,10,4048
22200672,1610612763,1610612739,115,114,1,15,11,3963
22200670,1610612742,1610612737,122,130,-8,10,7,3742
22200669,1610612752,1610612764,105,116,-11,20,18,5264
22200679,1610612738,1610612744,121,118,3,18,8,3844
22200682,1610612757,1610612755,95,105,-10,13,5,5557
22200681,1610612756,1610612751,117,112,5,12,2,5156
22200678,1610612765,1610612741,108,126,-18,17,11,4165
22200680,1610612750,1610612761,128,126,2,8,8,5061
22200683,1610612753,1610612740,123,110,13,5,11,4053
22200684,1610612737,1610612752,139,124,15,14,9,3752
22200685,1610612739,1610612744,114,120,-6,10,14,3944
22200686,1610612742,1610612748,115,90,25,10,5,4248
22200687,1610612759,1610612746,126,131,-5,12,11,4659
22200689,1610612762,1610612751,106,117,-11,13,6,5162
22200688,1610612743,1610612754,134,111,23,12,16,4354
22200690,1610612747,1610612763,122,121,1,10,24,4763
22200691,1610612758,1610612760,118,113,5,13,8,5860
22200693,1610612764,1610612753,138,118,20,9,9,5364
22200695,1610612739,1610612749,114,102,12,9,7,3949
22200694,1610612737,1610612766,118,122,-4,6,6,3766
22200696,1610612750,1610612745,113,104,9,3,15,4550
22200697,1610612756,1610612754,112,107,5,14,11,5456
22200698,1610612758,1610612755,127,129,-2,4,16,5558
22200692,1610612761,1610612738,104,106,-2,6,11,3861
22200699,1610612748,1610612740,100,96,4,12,8,4048
22200705,1610612757,1610612747,112,121,-9,11,10,4757
22200701,1610612742,1610612746,98,112,-14,12,9,4246
22200702,1610612743,1610612760,99,101,-2,10,14,4360
22200700,1610612761,1610612752,125,116,9,17,14,5261
22200704,1610612744,1610612751,116,120,-4,10,9,4451
22200703,1610612756,1610612763,112,110,2,6,15,5663
22200707,1610612753,1610612738,113,98,15,8,8,3853
22200706,1610612765,1610612749,130,150,-20,11,13,4965
22200711,1610612757,1610612759,147,127,20,8,14,5759
22200712,1610612758,1610612763,133,100,33,10,10,5863
22200708,1610612741,1610612737,111,100,11,15,9,3741
22200710,1610612762,1610612766,120,102,18,9,11,6266
22200709,1610612745,1610612750,119,114,5,12,12,4550
22200713,1610612754,1610612741,116,110,6,14,11,4154
22200718,1610612756,1610612766,128,97,31,15,10,5666
22200715,1610612752,1610612739,105,103,2,9,10,3952
22200719,1610612747,1610612746,115,133,-18,9,7,4647
22200717,1610612742,1610612764,126,127,-1,8,6,4264
22200716,1610612740,1610612743,98,99,-1,14,7,4043
22200714,1610612748,1610612738,98,95,3,14,5,3848
22200726,1610612744,1610612763,122,120,2,14,11,4463
22200727,1610612757,1610612762,134,124,10,6,8,5762
22200720,1610612753,1610612754,126,120,6,9,10,5354
22200729,1610612747,1610612759,113,104,9,11,17,4759
22200721,1610612755,1610612751,137,133,4,11,6,5155
22200725,1610612760,1610612737,132,137,-5,12,11,3760
22200723,1610612749,1610612743,107,99,8,7,15,4349
22200724,1610612740,1610612750,102,111,-9,8,4,4050
22200722,1610612745,1610612764,103,108,-5,17,15,4564
22200728,1610612758,1610612761,95,113,-18,4,11,5861
22200734,1610612756,1610612742,95,99,-4,13,7,4256
22200733,1610612745,1610612739,95,113,-18,10,11,3945
22200732,1610612766,1610612741,111,96,15,6,7,4166
22200730,1610612738,1610612752,117,120,-3,15,10,3852
22200735,1610612746,1610612759,138,100,38,6,11,4659
22200731,1610612751,1610612765,122,130,-8,15,15,5165
22200738,1610612748,1610612753,110,105,5,5,2,4853
22200737,1610612750,1610612763,111,100,11,9,15,5063
22200740,1610612744,1610612761,129,117,12,5,14,4461
22200736,1610612754,1610612749,131,141,-10,5,14,4954
22200739,1610612760,1610612739,112,100,12,10,11,3960
22200743,1610612765,1610612745,114,117,-3,8,16,4565
22200744,1610612753,1610612741,109,128,-19,6,4,4153
22200751,1610612757,1610612761,105,123,-18,3,15,5761
22200745,1610612737,1610612746,113,120,-7,15,6,3746
22200749,1610612738,1610612747,125,121,4,7,11,3847
22200750,1610612762,1610612742,108,100,8,13,7,4262
22200746,1610612750,1610612758,117,110,7,9,10,5058
22200748,1610612759,1610612756,118,128,-10,17,17,5659
22200747,1610612740,1610612764,103,113,-10,8,13,4064
22200741,1610612755,1610612743,126,119,7,12,6,4355
22200742,1610612751,1610612752,122,115,7,9,14,5152
22200753,1610612763,1610612754,112,100,12,15,11,5463
22200755,1610612749,1610612740,135,110,25,12,8,4049
22200752,1610612766,1610612748,122,117,5,11,10,4866
22200754,1610612739,1610612746,122,99,23,4,15,3946
22200756,1610612755,1610612753,109,119,-10,8,15,5355
22200760,1610612759,1610612764,106,127,-21,14,5,5964
22200757,1610612751,1610612747,121,104,17,12,16,4751
22200759,1610612760,1610612744,120,128,-8,8,6,4460
22200758,1610612750,1610612758,111,118,-7,8,10,5058
22200763,1610612757,1610612737,129,125,4,3,17,3757
22200761,1610612742,1610612765,111,105,6,9,9,4265
22200762,1610612756,1610612761,114,106,8,13,16,5661
22200768,1610612743,1610612740,122,113,9,10,8,4043
22200767,1610612749,1610612766,124,115,9,16,18,4966
22200766,1610612741,1610612746,103,108,-5,6,11,4146
22200765,1610612752,1610612747,123,129,-6,13,11,4752
22200764,1610612739,1610612748,97,100,-3,5,9,3948
22200775,1610612759,1610612758,109,119,-10,8,6,5859
22200774,1610612750,1610612744,119,114,5,10,9,4450
22200777,1610612756,1610612737,100,132,-32,12,6,3756
22200776,1610612762,1610612761,131,128,3,13,25,6162
22200770,1610612755,1610612753,105,94,11,7,12,5355
22200773,1610612745,1610612760,112,106,6,24,24,4560
22200771,1610612763,1610612757,112,122,-10,12,9,5763
22200772,1610612738,1610612751,139,96,43,11,5,3851
22200783,1610612743,1610612744,134,117,17,7,10,4344
22200784,1610612749,1610612746,106,105,1,8,9,4649
22200781,1610612741,1610612766,114,98,16,8,16,4166
22200780,1610612752,1610612748,106,104,2,11,9,4852
22200782,1610612742,1610612740,111,106,5,6,12,4042
22200778,1610612754,1610612747,111,112,-1,6,13,4754
22200779,1610612739,1610612763,128,113,15,9,11,3963
22200790,1610612750,1610612753,120,127,-7,12,13,5053
22200789,1610612745,1610612761,111,117,-6,6,13,4561
22200791,1610612759,1610612755,125,137,-12,9,14,5559
22200788,1610612738,1610612756,94,106,-12,3,10,3856
22200785,1610612765,1610612766,118,112,6,12,8,6566
22200787,1610612764,1610612757,116,124,-8,9,11,5764
22200786,1610612754,1610612758,107,104,3,9,11,5458
22200792,1610612762,1610612737,108,115,-7,13,14,3762
22200796,1610612741,1610612757,129,121,8,6,7,4157
22200799,1610612760,1610612745,153,121,32,9,9,4560
22200797,1610612749,1610612748,123,115,8,10,13,4849
22200800,1610612744,1610612742,119,113,6,5,10,4244
22200801,1610612743,1610612737,128,108,20,12,10,3743
22200793,1610612751,1610612764,125,123,2,10,6,5164
22200795,1610612752,1610612746,128,134,-6,10,9,4652
22200794,1610612765,1610612756,100,116,-16,9,10,5665
22200798,1610612740,1610612747,131,126,5,14,13,4047
22200805,1610612763,1610612761,103,106,-3,8,11,6163
22200804,1610612752,1610612755,108,97,11,14,8,5255
22200807,1610612740,1610612758,136,104,32,12,11,4058
22200806,1610612750,1610612743,128,98,30,5,3,4350
22200803,1610612754,1610612739,103,122,-19,12,8,3954
22200802,1610612766,1610612753,113,119,-6,8,18,5366
22200812,1610612745,1610612758,120,140,-20,11,7,4558
22200809,1610612764,1610612739,91,114,-23,7,7,3964
22200813,1610612762,1610612742,111,124,-13,10,17,4262
22200815,1610612757,1610612749,108,127,-19,1,7,4957
22200814,1610612744,1610612760,141,114,27,11,7,4460
22200808,1610612765,1610612738,99,111,-12,9,10,3865
22200811,1610612741,1610612759,128,104,24,7,6,4159
22200810,1610612751,1610612746,116,124,-8,8,11,4651
22200816,1610612753,1610612752,98,102,-4,9,11,5253
22200821,1610612747,1610612760,130,133,-3,6,7,4760
22200820,1610612743,1610612750,146,112,34,6,8,4350
22200817,1610612751,1610612756,112,116,-4,5,16,5156
22200819,1610612763,1610612741,104,89,15,5,11,4163
22200818,1610612740,1610612737,116,107,9,13,10,3740
22200823,1610612764,1610612766,118,104,14,11,12,6466
22200829,1610612746,1610612742,104,110,-6,9,8,4246
22200828,1610612762,1610612750,118,143,-25,21,8,5062
22200825,1610612748,1610612754,116,111,5,15,5,4854
22200822,1610612739,1610612765,113,85,28,13,9,3965
22200830,1610612757,1610612744,125,122,3,12,10,4457
22200824,1610612738,1610612755,106,99,7,5,8,3855
22200826,1610612761,1610612759,112,98,14,9,7,5961
22200827,1610612745,1610612758,128,130,-2,15,10,4558
22200831,1610612753,1610612743,115,104,11,15,7,4353
22200833,1610612751,1610612741,116,105,11,11,8,4151
22200834,1610612747,1610612749,106,115,-9,11,16,4749
22200832,1610612737,1610612756,116,107,9,20,9,3756
22200841,1610612763,1610612750,128,107,21,9,7,5063
22200843,1610612757,1610612760,129,138,-9,9,10,5760
22200836,1610612754,1610612756,104,117,-13,11,19,5456
22200837,1610612755,1610612752,119,108,11,6,4,5255
22200839,1610612761,1610612762,116,122,-6,9,9,6162
22200842,1610612740,1610612739,107,118,-11,11,12,3940
22200835,1610612765,1610612759,138,131,7,21,13,5965
22200845,1610612746,1610612749,106,119,-13,3,9,4649
22200844,1610612758,1610612742,114,122,-8,5,11,4258
22200840,1610612748,1610612745,97,95,2,6,10,4548
22200838,1610612738,1610612766,127,116,11,5,11,3866
22200847,1610612766,1610612743,105,119,-14,5,14,4366
22200849,1610612764,1610612754,127,113,14,8,17,5464
22200854,1610612758,1610612742,133,128,5,11,7,4258
22200853,1610612744,1610612747,103,109,-6,7,10,4447
22200852,1610612739,1610612741,97,89,8,10,6,3941
22200851,1610612752,1610612762,126,120,6,20,11,5262
22200848,1610612753,1610612748,103,107,-4,12,11,4853
22200850,1610612737,1610612759,125,106,19,14,14,3759
22200846,1610612751,1610612755,98,101,-3,12,8,5155
22200856,1610612761,1610612765,119,118,1,13,6,6165
22200855,1610612738,1610612763,119,109,10,15,3,3863
22200860,1610612755,1610612745,123,104,19,7,15,4555
22200858,1610612739,1610612759,117,109,8,11,11,3959
22200859,1610612754,1610612762,117,123,-6,8,11,5462
22200857,1610612766,1610612737,144,138,6,3,16,3766
22200861,1610612748,1610612743,108,112,-4,9,6,4348
22200862,1610612752,1610612751,124,106,18,6,10,5152
22200863,1610612741,1610612753,91,100,-9,10,7,4153
22200864,1610612760,1610612740,100,103,-3,14,4,4060
22200865,1610612742,1610612750,121,124,-3,9,10,4250
22200867,1610612757,1610612747,127,115,12,8,14,4757
22200866,1610612744,1610612764,135,126,9,11,9,4464
22200869,1610612749,1610612738,131,125,6,10,8,3849
22200871,1610612746,1610612744,134,124,10,12,8,4446
22200870,1610612756,1610612758,120,109,11,8,13,5658
22200872,1610612757,1610612764,101,126,-25,12,5,5764
22200868,1610612761,1610612753,123,113,10,13,9,5361
22200878,1610612751,1610612748,116,105,11,5,12,4851
22200882,1610612747,1610612740,120,102,18,6,13,4047
22200881,1610612743,1610612742,118,109,9,6,6,4243
22200880,1610612760,1610612745,133,96,37,10,14,4560
22200879,1610612763,1610612762,117,111,6,17,15,6263
22200875,1610612755,1610612739,118,112,6,8,10,3955
22200876,1610612737,1610612752,101,122,-21,8,10,3752
22200873,1610612766,1610612759,120,110,10,15,20,5966
22200874,1610612754,1610612741,117,113,4,6,6,4154
22200877,1610612738,1610612765,127,109,18,8,6,3865
22200884,1610612750,1610612764,106,114,-8,16,13,5064
22200883,1610612741,1610612749,100,112,-12,15,9,4149
22200885,1610612756,1610612746,107,116,-9,7,8,4656
22200894,1610612758,1610612757,133,116,17,12,9,5758
22200889,1610612755,1610612763,110,105,5,7,13,5563
22200890,1610612761,1610612740,115,110,5,11,6,4061
22200893,1610612747,1610612744,124,111,13,10,17,4447
22200887,1610612754,1610612738,138,142,-4,10,20,3854
22200888,1610612753,1610612765,108,106,2,12,6,5365
22200886,1610612739,1610612743,109,115,-6,13,18,3943
22200891,1610612742,1610612759,142,116,26,3,10,4259
22200892,1610612762,1610612760,120,119,1,17,20,6062
22200902,1610612746,1610612758,175,176,-1,7,12,4658
22200897,1610612749,1610612748,128,99,29,10,9,4849
22200900,1610612741,1610612751,131,87,44,12,5,4151
22200898,1610612750,1610612766,113,121,-8,7,11,5066
22200899,1610612756,1610612760,124,115,9,15,14,5660
22200901,1610612744,1610612745,116,101,15,7,13,4445
22200896,1610612737,1610612739,136,119,17,5,10,3739
22200895,1610612764,1610612752,109,115,-6,3,12,5264
22200907,1610612763,1610612743,112,94,18,11,11,4363
22200908,1610612755,1610612738,107,110,-3,8,9,3855
22200909,1610612762,1610612759,118,102,16,15,9,5962
22200903,1610612765,1610612761,91,95,-4,17,10,6165
22200904,1610612766,1610612748,108,103,5,11,7,4866
22200905,1610612753,1610612754,108,121,-13,15,10,5354
22200906,1610612752,1610612740,128,106,22,11,13,4052
22200917,1610612757,1610612745,131,114,17,6,18,4557
22200916,1610612744,1610612750,109,104,5,16,10,4450
22200918,1610612743,1610612746,134,124,10,11,6,4346
22200915,1610612760,1610612758,115,124,-9,9,13,5860
22200913,1610612742,1610612747,108,111,-3,11,17,4247
22200912,1610612741,1610612764,102,82,20,8,12,4164
22200914,1610612739,1610612761,118,93,25,8,13,3961
22200911,1610612737,1610612751,129,127,2,13,6,3751
22200910,1610612749,1610612756,104,101,3,11,19,4956
22200920,1610612755,1610612748,99,101,-2,9,12,4855
22200921,1610612752,1610612738,109,94,15,7,7,3852
22200922,1610612740,1610612753,93,101,-8,9,11,4053
22200919,1610612766,1610612765,117,106,11,7,10,6566
22200926,1610612745,1610612743,112,133,-21,10,11,4345
22200931,1610612744,1610612757,123,105,18,12,9,4457
22200932,1610612746,1610612750,101,108,-7,9,10,4650
22200930,1610612762,1610612759,94,102,-8,14,9,5962
22200927,1610612763,1610612747,121,109,12,14,14,4763
22200925,1610612761,1610612741,104,98,6,19,6,4161
22200929,1610612742,1610612754,122,124,-2,9,5,4254
22200923,1610612737,1610612764,116,119,-3,13,16,3764
22200924,1610612751,1610612749,104,118,-14,3,11,4951
22200928,1610612760,1610612758,117,123,-6,12,8,5860
22200937,1610612752,1610612751,142,118,24,7,5,5152
22200936,1610612748,1610612755,96,119,-23,5,9,4855
22200935,1610612738,1610612739,117,113,4,7,10,3839
22200933,1610612766,1610612756,91,105,-14,12,5,5666
22200934,1610612765,1610612741,115,117,-2,7,10,4165
22200938,1610612745,1610612763,99,113,-14,17,8,4563
22200939,1610612749,1610612753,139,117,22,8,12,4953
22200940,1610612760,1610612747,117,123,-6,12,10,4760
22200941,1610612757,1610612740,110,121,-11,12,11,4057
22200945,1610612744,1610612746,115,91,24,15,9,4446
22200942,1610612764,1610612761,119,108,11,9,13,6164
22200943,1610612742,1610612755,133,126,7,5,5,4255
22200944,1610612759,1610612754,110,99,11,13,6,5459
22200946,1610612766,1610612753,106,117,-11,8,13,5366
22200948,1610612738,1610612751,105,115,-10,9,13,3851
22200950,1610612741,1610612756,104,125,-21,9,13,4156
22200949,1610612748,1610612752,120,122,-2,11,6,4852
22200951,1610612760,1610612762,130,103,27,11,10,6062
22200953,1610612744,1610612740,108,99,9,9,7,4044
22200954,1610612758,1610612746,128,127,1,9,6,4658
22200952,1610612743,1610612763,113,97,16,13,10,4363
22200955,1610612747,1610612750,102,110,-8,11,10,4750
22200947,1610612737,1610612757,129,111,18,10,9,3757
22200957,1610612739,1610612765,114,90,24,8,12,3965
22200956,1610612764,1610612761,109,116,-7,9,10,6164
22200959,1610612759,1610612745,110,122,-12,13,14,4559
22200958,1610612748,1610612737,117,109,8,12,10,3748
22200960,1610612749,1610612755,130,133,-3,11,9,4955
22200961,1610612758,1610612750,134,138,-4,11,6,5058
22200973,1610612764,1610612749,111,117,-6,20,7,4964
22200969,1610612738,1610612752,129,131,-2,17,11,3852
22200966,1610612753,1610612757,119,122,-3,6,9,5357
22200965,1610612751,1610612766,102,86,16,8,5,5166
22200964,1610612747,1610612744,113,105,8,10,7,4447
22200968,1610612760,1610612762,129,119,10,11,12,6062
22200963,1610612741,1610612754,122,125,-3,4,13,4154
22200970,1610612746,1610612763,135,129,6,13,2,4663
22200962,1610612742,1610612756,126,130,-4,5,9,4256
22200967,1610612745,1610612759,142,110,32,6,13,4559
22200977,1610612765,1610612757,104,110,-6,16,5,5765
22200972,1610612754,1610612755,143,147,-4,5,5,5455
22200974,1610612748,1610612737,130,128,2,8,12,3748
22200971,1610612739,1610612738,118,114,4,16,15,3839
22200976,1610612758,1610612740,123,108,15,6,7,4058
22200975,1610612743,1610612761,118,113,5,12,11,4361
22200981,1610612745,1610612751,96,118,-22,15,5,4551
22200982,1610612760,1610612744,137,128,9,13,8,4460
22200769,1610612765,1610612764,117,119,-2,10,9,6465
22200978,1610612753,1610612749,123,134,-11,10,3,4953
22200980,1610612750,1610612755,94,117,-23,6,8,5055
22200979,1610612752,1610612766,105,112,-7,10,10,5266
22200984,1610612747,1610612763,112,103,9,7,6,4763
22200983,1610612742,1610612762,120,116,4,3,6,4262
22200985,1610612764,1610612737,120,122,-2,6,8,3764
22200986,1610612738,1610612757,115,93,22,5,6,3857
22200988,1610612740,1610612742,113,106,7,9,5,4042
22200987,1610612748,1610612739,100,104,-4,10,7,3948
22200989,1610612743,1610612741,96,117,-21,11,9,4143
22200991,1610612746,1610612761,108,100,8,9,15,4661
22200990,1610612756,1610612760,132,101,31,14,7,5660
22200994,1610612753,1610612762,124,131,-7,12,11,5362
22200993,1610612754,1610612745,134,125,9,8,20,4554
22200996,1610612763,1610612744,131,110,21,9,8,4463
22200992,1610612765,1610612766,103,113,-10,17,13,6566
22200995,1610612749,1610612751,118,113,5,20,15,4951
22200997,1610612758,1610612752,122,117,5,6,23,5258
22201003,1610612747,1610612761,122,112,10,5,10,4761
22201001,1610612750,1610612751,123,124,-1,12,12,5051
22201000,1610612748,1610612739,119,115,4,11,8,3948
22201002,1610612759,1610612743,128,120,8,13,8,4359
22200999,1610612764,1610612737,107,114,-7,7,13,3764
22200998,1610612755,1610612757,120,119,1,12,5,5557
22201004,1610612746,1610612752,106,95,11,7,20,4652
22201006,1610612765,1610612754,115,121,-6,12,18,5465
22201005,1610612766,1610612762,111,119,-8,11,20,6266
22201007,1610612753,1610612748,126,114,12,15,5,4853
22201008,1610612737,1610612738,125,134,-9,13,5,3738
22201013,1610612756,1610612758,119,128,-9,7,8,5658
22201012,1610612744,1610612749,125,116,9,18,7,4449
22201011,1610612740,1610612760,96,110,-14,8,4,4060
22201010,1610612763,1610612742,112,108,4,11,10,4263
22201009,1610612745,1610612741,111,119,-8,6,13,4145
22201017,1610612740,1610612757,127,110,17,8,10,4057
22201018,1610612759,1610612760,90,102,-12,10,12,5960
22201016,1610612755,1610612764,112,93,19,9,6,5564
22201015,1610612766,1610612739,108,114,-6,7,11,3966
22201014,1610612743,1610612751,120,122,-2,15,4,4351
22201019,1610612747,1610612752,108,112,-4,10,12,4752
22201020,1610612765,1610612754,117,97,20,19,13,5465
22201021,1610612737,1610612750,115,136,-21,18,5,3750
22201023,1610612742,1610612763,88,104,-16,8,7,4263
22201022,1610612748,1610612762,119,115,4,9,16,4862
22201024,1610612745,1610612738,111,109,2,15,10,3845
22201026,1610612758,1610612749,124,133,-9,15,5,4958
22201025,1610612744,1610612756,123,112,11,9,17,4456
22201030,1610612740,1610612747,108,123,-15,15,15,4047
22201032,1610612759,1610612753,132,114,18,7,13,5359
22201029,1610612761,1610612743,125,110,15,14,4,4361
22201028,1610612764,1610612765,117,97,20,10,19,6465
22201027,1610612766,1610612739,104,120,-16,6,8,3966
22201031,1610612760,1610612751,121,107,14,14,11,5160
22201033,1610612756,1610612749,104,116,-12,8,13,4956
22201034,1610612757,1610612752,107,123,-16,11,9,5257
22201037,1610612741,1610612758,114,117,-3,13,5,4158
22201040,1610612759,1610612742,128,137,-9,16,10,4259
22201041,1610612746,1610612744,134,126,8,16,7,4446
22201038,1610612745,1610612747,114,110,4,16,11,4547
22201039,1610612750,1610612738,102,104,-2,8,8,3850
22201035,1610612739,1610612755,109,118,-9,12,13,3955
22201036,1610612748,1610612763,138,119,19,8,12,4863
22201042,1610612765,1610612743,100,119,-19,13,13,4365
22201043,1610612751,1610612758,96,101,-5,3,13,5158
22201044,1610612761,1610612760,128,111,17,19,11,6061
22201045,1610612749,1610612754,123,139,-16,9,8,4954
22201046,1610612756,1610612753,116,113,3,7,11,5356
22201047,1610612766,1610612755,82,121,-39,7,14,5566
22201048,1610612737,1610612744,127,119,8,13,16,3744
22201049,1610612739,1610612764,117,94,23,9,6,3964
22201051,1610612745,1610612740,114,112,2,15,8,4045
22201052,1610612759,1610612763,120,126,-6,16,15,5963
22201050,1610612741,1610612750,139,131,8,6,14,4150
22201053,1610612757,1610612738,112,126,-14,8,18,3857
22201054,1610612747,1610612742,110,111,-1,13,7,4247
22201062,1610612762,1610612738,118,117,1,17,5,3862
22201059,1610612764,1610612758,118,132,-14,12,7,5864
22201061,1610612763,1610612744,133,119,14,11,15,4463
22201057,1610612754,1610612755,121,141,-20,12,6,5455
22201060,1610612741,1610612748,113,99,14,5,14,4148
22201058,1610612761,1610612750,122,107,15,9,9,5061
22201056,1610612746,1610612753,108,113,-5,13,9,4653
22201055,1610612752,1610612743,116,110,6,15,6,4352
22201063,1610612751,1610612743,102,108,-6,9,6,4351
22201070,1610612747,1610612753,111,105,6,9,13,4753
22201069,1610612757,1610612746,102,117,-15,11,18,4657
22201068,1610612749,1610612761,118,111,7,7,9,4961
22201067,1610612745,1610612740,107,117,-10,8,10,4045
22201066,1610612765,1610612748,100,112,-12,9,8,4865
22201065,1610612759,1610612737,126,118,8,10,20,3759
22201064,1610612760,1610612756,124,120,4,6,9,5660
